1111111111
10000000c1
1011111111
1011111011
1000000001
1110111111
1m00000001
1111111111