11111111111111111111
1m000000000000000001
10011111111111111001
10000000000000001001
10111111111111101001
10000000000000101001
10111111111110101001
10000000000010101001
10111111110010101001
10000000010010101001
10111111110110101001
10000000000110101001
10111111111110101001
10000000000000101001
10111111111111101001
10000000000000001001
10111111111111111111
1000000000000000c111
11111111111111111111
